District,Age,Men,Women,Total,Check,Diff
Adrar,0-4 Ans,24567,23287,47854,47854,0
Adrar,5-9 ans,22351,21253,43604,43604,0
Adrar,10-14 ans,23108,22451,45559,45559,0
Adrar,15-19 ans,24561,23200,47761,47761,0
Adrar,20-24 ans,23822,23175,46997,46997,0
Adrar,25-29 ans,20097,19642,39739,39739,0
Adrar,30-34 ans,12303,12401,24704,24704,0
Adrar,35-39 ans,10824,10921,21746,21745,-1
Adrar,40-44 ans,9989,9616,19605,19605,0
Adrar,45-49 ans,8868,8565,17432,17433,1
Adrar,50-54ans,5912,5533,11445,11445,0
Adrar,55-59 ans,4649,4744,9393,9393,0
Adrar,60-64 ans,3677,3239,6916,6916,0
Adrar,65-69 ans,3456,3001,6457,6457,0
Adrar,70-74 ans,2232,1879,4110,4111,1
Adrar,75-79 ans,1842,1628,3469,3470,1
Adrar,80-84 ans,908,664,1571,1572,1
Adrar,85 ans &  +,640,639,1279,1279,0
Laghouat,0-4 Ans,28569,26104,54673,54673,0
Laghouat,5-9 ans,25226,24015,49241,49241,0
Laghouat,10-14 ans,25001,23988,48989,48989,0
Laghouat,15-19 ans,25447,24725,50172,50172,0
Laghouat,20-24 ans,23878,24001,47879,47879,0
Laghouat,25-29 ans,21567,21949,43516,43516,0
Laghouat,30-34 ans,16877,16633,33510,33510,0
Laghouat,35-39 ans,15065,14633,29698,29698,0
Laghouat,40-44 ans,12027,12038,24065,24065,0
Laghouat,45-49 ans,10253,9798,20051,20051,0
Laghouat,50-54ans,7917,7095,15012,15012,0
Laghouat,55-59 ans,5912,5369,11281,11281,0
Laghouat,60-64 ans,3522,3190,6712,6712,0
Laghouat,65-69 ans,4000,3415,7415,7415,0
Laghouat,70-74 ans,2927,2567,5494,5494,0
Laghouat,75-79 ans,2065,1653,3718,3718,0
Laghouat,80-84 ans,1121,832,1953,1953,0
Laghouat,85 ans &  +,826,700,1526,1526,0
Batna,0-4 Ans,58167,55186,113353,113353,0
Batna,5-9 ans,50408,48360,98769,98768,-1
Batna,10-14 ans,59172,56649,115821,115821,0
Batna,15-19 ans,67342,64755,132096,132097,1
Batna,20-24 ans,65472,63675,129147,129147,0
Batna,25-29 ans,54737,52617,107355,107354,-1
Batna,30-34 ans,42250,42152,84402,84402,0
Batna,35-39 ans,33894,34888,68782,68782,0
Batna,40-44 ans,29959,31178,61137,61137,0
Batna,45-49 ans,26470,27691,54161,54161,0
Batna,50-54ans,21325,21541,42866,42866,0
Batna,55-59 ans,17177,16218,33394,33395,1
Batna,60-64 ans,10363,10516,20880,20879,-1
Batna,65-69 ans,9367,9603,18970,18970,0
Batna,70-74 ans,7691,8014,15705,15705,0
Batna,75-79 ans,5853,5734,11586,11587,1
Batna,80-84 ans,3427,3138,6566,6565,-1
Batna,85 ans &  +,2059,2215,4275,4274,-1
Chlef,0-4 Ans,51186,48293,99479,99479,0
Chlef,5-9 ans,44003,42433,86436,86436,0
Chlef,10-14 ans,50874,48970,99844,99844,0
Chlef,15-19 ans,59479,58386,117865,117865,0
Chlef,20-24 ans,61818,62127,123946,123945,-1
Chlef,25-29 ans,52340,52219,104559,104559,0
Chlef,30-34 ans,38521,39784,78305,78305,0
Chlef,35-39 ans,30427,31995,62423,62422,-1
Chlef,40-44 ans,25750,27359,53109,53109,0
Chlef,45-49 ans,21116,22106,43222,43222,0
Chlef,50-54ans,18239,18459,36698,36698,0
Chlef,55-59 ans,15139,14382,29521,29521,0
Chlef,60-64 ans,9338,8919,18257,18257,0
Chlef,65-69 ans,7979,7933,15912,15912,0
Chlef,70-74 ans,7103,6913,14016,14016,0
Chlef,75-79 ans,4913,4746,9658,9659,1
Chlef,80-84 ans,2324,2201,4525,4525,0
Chlef,85 ans &  +,1360,1547,2907,2907,0
Oum El Bouaghi,0-4 Ans,33069,31101,64171,64170,-1
Oum El Bouaghi,5-9 ans,26681,25430,52111,52111,0
Oum El Bouaghi,10-14 ans,31979,30121,62099,62100,1
Oum El Bouaghi,15-19 ans,36435,35309,71744,71744,0
Oum El Bouaghi,20-24 ans,36329,35941,72270,72270,0
Oum El Bouaghi,25-29 ans,30981,30762,61743,61743,0
Oum El Bouaghi,30-34 ans,23473,23154,46627,46627,0
Oum El Bouaghi,35-39 ans,18726,18680,37405,37406,1
Oum El Bouaghi,40-44 ans,17070,17610,34681,34680,-1
Oum El Bouaghi,45-49 ans,16078,16384,32462,32462,0
Oum El Bouaghi,50-54ans,12705,12800,25505,25505,0
Oum El Bouaghi,55-59 ans,9634,9305,18939,18939,0
Oum El Bouaghi,60-64 ans,5417,5810,11227,11227,0
Oum El Bouaghi,65-69 ans,5171,5323,10494,10494,0
Oum El Bouaghi,70-74 ans,4305,4030,8335,8335,0
Oum El Bouaghi,75-79 ans,3253,2905,6158,6158,0
Oum El Bouaghi,80-84 ans,1631,1578,3210,3209,-1
Oum El Bouaghi,85 ans &  +,942,984,1926,1926,0
Bejaia,0-4 Ans,34047,32328,66376,66375,-1
Bejaia,5-9 ans,31581,29900,61481,61481,0
Bejaia,10-14 ans,39479,37771,77250,77250,0
Bejaia,15-19 ans,49044,47420,96463,96464,1
Bejaia,20-24 ans,57216,53978,111193,111194,1
Bejaia,25-29 ans,52309,47989,100299,100298,-1
Bejaia,30-34 ans,41986,38785,80771,80771,0
Bejaia,35-39 ans,34167,32463,66630,66630,0
Bejaia,40-44 ans,28305,27392,55697,55697,0
Bejaia,45-49 ans,22536,21418,43954,43954,0
Bejaia,50-54ans,19639,18568,38206,38207,1
Bejaia,55-59 ans,17338,16182,33520,33520,0
Bejaia,60-64 ans,9911,10546,20457,20457,0
Bejaia,65-69 ans,8602,9725,18327,18327,0
Bejaia,70-74 ans,7295,8664,15959,15959,0
Bejaia,75-79 ans,5831,6731,12562,12562,0
Bejaia,80-84 ans,3372,3633,7005,7005,0
Bejaia,85 ans &  +,2269,2586,4856,4855,-1
Biskra,0-4 Ans,42031,39153,81184,81184,0
Biskra,5-9 ans,37527,35585,73112,73112,0
Biskra,10-14 ans,41516,39940,81456,81456,0
Biskra,15-19 ans,42980,40846,83825,83826,1
Biskra,20-24 ans,39897,39787,79684,79684,0
Biskra,25-29 ans,34082,33602,67684,67684,0
Biskra,30-34 ans,25617,25829,51446,51446,0
Biskra,35-39 ans,22046,22705,44750,44751,1
Biskra,40-44 ans,18823,18974,37797,37797,0
Biskra,45-49 ans,15767,16049,31817,31816,-1
Biskra,50-54ans,12734,12680,25414,25414,0
Biskra,55-59 ans,9316,8736,18052,18052,0
Biskra,60-64 ans,5735,5817,11552,11552,0
Biskra,65-69 ans,5354,5387,10741,10741,0
Biskra,70-74 ans,4523,4575,9098,9098,0
Biskra,75-79 ans,3862,3600,7462,7462,0
Biskra,80-84 ans,1785,1627,3412,3412,0
Biskra,85 ans &  +,1330,1235,2565,2565,0
Blida,0-4 Ans,52988,50716,103705,103704,-1
Blida,5-9 ans,42504,40825,83330,83329,-1
Blida,10-14 ans,46841,44706,91548,91547,-1
Blida,15-19 ans,51709,49548,101257,101257,0
Blida,20-24 ans,52612,51698,104309,104310,1
Blida,25-29 ans,49433,48580,98013,98013,0
Blida,30-34 ans,41389,40816,82205,82205,0
Blida,35-39 ans,37962,37941,75903,75903,0
Blida,40-44 ans,32787,32295,65082,65082,0
Blida,45-49 ans,25131,24311,49442,49442,0
Blida,50-54ans,21887,20317,42204,42204,0
Blida,55-59 ans,17058,15315,32372,32373,1
Blida,60-64 ans,11950,11055,23004,23005,1
Blida,65-69 ans,9422,8938,18359,18360,1
Blida,70-74 ans,6885,7059,13944,13944,0
Blida,75-79 ans,4727,4767,9494,9494,0
Blida,80-84 ans,2298,2232,4530,4530,0
Blida,85 ans &  +,1414,1509,2923,2923,0
Tamanrasset,0-4 Ans,12814,12127,24942,24941,-1
Tamanrasset,5-9 ans,10712,10263,20974,20975,1
Tamanrasset,10-14 ans,10262,9712,19974,19974,0
Tamanrasset,15-19 ans,10212,9897,20109,20109,0
Tamanrasset,20-24 ans,9082,9292,18373,18374,1
Tamanrasset,25-29 ans,8424,8122,16546,16546,0
Tamanrasset,30-34 ans,5833,5676,11509,11509,0
Tamanrasset,35-39 ans,5460,5189,10650,10649,-1
Tamanrasset,40-44 ans,4702,4307,9010,9009,-1
Tamanrasset,45-49 ans,4054,3505,7559,7559,0
Tamanrasset,50-54ans,2564,2023,4587,4587,0
Tamanrasset,55-59 ans,2032,1747,3779,3779,0
Tamanrasset,60-64 ans,1450,1087,2537,2537,0
Tamanrasset,65-69 ans,1249,1081,2330,2330,0
Tamanrasset,70-74 ans,730,569,1299,1299,0
Tamanrasset,75-79 ans,547,505,1053,1052,-1
Tamanrasset,80-84 ans,209,176,385,385,0
Tamanrasset,85 ans &  +,207,223,430,430,0
Bechar,0-4 Ans,14791,14731,29522,29522,0
Bechar,5-9 ans,12222,11643,23865,23865,0
Bechar,10-14 ans,12967,12720,25687,25687,0
Bechar,15-19 ans,14173,13821,27994,27994,0
Bechar,20-24 ans,14862,15455,30317,30317,0
Bechar,25-29 ans,13866,14388,28254,28254,0
Bechar,30-34 ans,11265,11059,22324,22324,0
Bechar,35-39 ans,9230,9181,18411,18411,0
Bechar,40-44 ans,7654,7771,15425,15425,0
Bechar,45-49 ans,6540,6211,12751,12751,0
Bechar,50-54ans,5383,5276,10659,10659,0
Bechar,55-59 ans,3721,3750,7471,7471,0
Bechar,60-64 ans,2616,2524,5140,5140,0
Bechar,65-69 ans,2261,2014,4275,4275,0
Bechar,70-74 ans,1622,1637,3259,3259,0
Bechar,75-79 ans,1172,1243,2415,2415,0
Bechar,80-84 ans,663,633,1296,1296,0
Bechar,85 ans &  +,424,570,994,994,0
Bouira,0-4 Ans,32037,30344,62381,62381,0
Bouira,5-9 ans,27225,26008,53233,53233,0
Bouira,10-14 ans,32391,31059,63450,63450,0
Bouira,15-19 ans,38880,37703,76584,76583,-1
Bouira,20-24 ans,41900,39952,81853,81852,-1
Bouira,25-29 ans,39770,37971,77742,77741,-1
Bouira,30-34 ans,31096,29867,60963,60963,0
Bouira,35-39 ans,24171,24184,48354,48355,1
Bouira,40-44 ans,19308,18988,38296,38296,0
Bouira,45-49 ans,15721,15248,30970,30969,-1
Bouira,50-54ans,13360,13491,26852,26851,-1
Bouira,55-59 ans,10790,10250,21040,21040,0
Bouira,60-64 ans,7063,7217,14279,14280,1
Bouira,65-69 ans,6363,6476,12840,12839,-1
Bouira,70-74 ans,4935,5358,10293,10293,0
Bouira,75-79 ans,3896,3925,7820,7821,1
Bouira,80-84 ans,2199,2103,4302,4302,0
Bouira,85 ans &  +,1692,1583,3274,3275,1
Tebessa,0-4 Ans,32387,30071,62459,62458,-1
Tebessa,5-9 ans,29479,28456,57935,57935,0
Tebessa,10-14 ans,35243,33909,69152,69152,0
Tebessa,15-19 ans,38870,37314,76184,76184,0
Tebessa,20-24 ans,37145,37694,74839,74839,0
Tebessa,25-29 ans,32116,32132,64247,64248,1
Tebessa,30-34 ans,23709,24430,48139,48139,0
Tebessa,35-39 ans,19309,20522,39832,39831,-1
Tebessa,40-44 ans,17938,18680,36618,36618,0
Tebessa,45-49 ans,15502,15901,31403,31403,0
Tebessa,50-54ans,12966,13126,26092,26092,0
Tebessa,55-59 ans,9526,8874,18400,18400,0
Tebessa,60-64 ans,5494,5722,11216,11216,0
Tebessa,65-69 ans,5738,5663,11401,11401,0
Tebessa,70-74 ans,4509,4396,8905,8905,0
Tebessa,75-79 ans,3342,3098,6441,6440,-1
Tebessa,80-84 ans,1658,1539,3198,3197,-1
Tebessa,85 ans &  +,1093,1006,2099,2099,0
Tlemcen,0-4 Ans,45129,43780,88909,88909,0
Tlemcen,5-9 ans,37728,36124,73852,73852,0
Tlemcen,10-14 ans,42290,41043,83333,83333,0
Tlemcen,15-19 ans,43545,42331,85876,85876,0
Tlemcen,20-24 ans,48643,46255,94898,94898,0
Tlemcen,25-29 ans,49080,45238,94319,94318,-1
Tlemcen,30-34 ans,41715,38738,80453,80453,0
Tlemcen,35-39 ans,35552,34283,69835,69835,0
Tlemcen,40-44 ans,31086,30416,61501,61502,1
Tlemcen,45-49 ans,24824,24548,49372,49372,0
Tlemcen,50-54ans,23419,22289,45708,45708,0
Tlemcen,55-59 ans,19227,17461,36688,36688,0
Tlemcen,60-64 ans,11990,12170,24160,24160,0
Tlemcen,65-69 ans,10357,10767,21123,21124,1
Tlemcen,70-74 ans,7544,8849,16393,16393,0
Tlemcen,75-79 ans,5115,6360,11475,11475,0
Tlemcen,80-84 ans,2820,3510,6330,6330,0
Tlemcen,85 ans &  +,2103,2609,4712,4712,0
Tizi Ouzou,0-4 Ans,38549,36612,75161,75161,0
Tizi Ouzou,5-9 ans,35638,33951,69589,69589,0
Tizi Ouzou,10-14 ans,44039,42078,86117,86117,0
Tizi Ouzou,15-19 ans,56681,54131,110812,110812,0
Tizi Ouzou,20-24 ans,68230,64706,132936,132936,0
Tizi Ouzou,25-29 ans,67399,61819,129217,129218,1
Tizi Ouzou,30-34 ans,53656,51171,104827,104827,0
Tizi Ouzou,35-39 ans,43395,42822,86217,86217,0
Tizi Ouzou,40-44 ans,36230,36684,72914,72914,0
Tizi Ouzou,45-49 ans,23548,24288,47836,47836,0
Tizi Ouzou,50-54ans,24478,24837,49315,49315,0
Tizi Ouzou,55-59 ans,22199,22371,44570,44570,0
Tizi Ouzou,60-64 ans,14223,15986,30209,30209,0
Tizi Ouzou,65-69 ans,11752,14661,26413,26413,0
Tizi Ouzou,70-74 ans,8880,12447,21327,21327,0
Tizi Ouzou,75-79 ans,7459,10823,18283,18282,-1
Tizi Ouzou,80-84 ans,4522,6734,11255,11256,1
Tizi Ouzou,85 ans &  +,3372,5294,8666,8666,0
Djelfa,0-4 Ans,77739,68265,146003,146004,1
Djelfa,5-9 ans,66468,61452,127919,127920,1
Djelfa,10-14 ans,66550,61870,128420,128420,0
Djelfa,15-19 ans,66949,63298,130247,130247,0
Djelfa,20-24 ans,60162,60718,120880,120880,0
Djelfa,25-29 ans,50862,51065,101927,101927,0
Djelfa,30-34 ans,35652,34358,70010,70010,0
Djelfa,35-39 ans,31531,30839,62371,62370,-1
Djelfa,40-44 ans,23778,23704,47482,47482,0
Djelfa,45-49 ans,21072,20841,41913,41913,0
Djelfa,50-54ans,14632,14427,29059,29059,0
Djelfa,55-59 ans,13576,12022,25598,25598,0
Djelfa,60-64 ans,8553,7567,16120,16120,0
Djelfa,65-69 ans,8919,7217,16136,16136,0
Djelfa,70-74 ans,6234,5066,11301,11300,-1
Djelfa,75-79 ans,4659,3417,8076,8076,0
Djelfa,80-84 ans,2228,1469,3697,3697,0
Djelfa,85 ans &  +,1910,1445,3355,3355,0
Tiaret,0-4 Ans,45808,43288,89096,89096,0
Tiaret,5-9 ans,38564,37620,76185,76184,-1
Tiaret,10-14 ans,44100,42805,86905,86905,0
Tiaret,15-19 ans,47805,46702,94507,94507,0
Tiaret,20-24 ans,46793,46765,93558,93558,0
Tiaret,25-29 ans,42481,42293,84774,84774,0
Tiaret,30-34 ans,32116,32635,64752,64751,-1
Tiaret,35-39 ans,27806,28596,56402,56402,0
Tiaret,40-44 ans,23711,24376,48088,48087,-1
Tiaret,45-49 ans,19563,19671,39234,39234,0
Tiaret,50-54ans,15900,15051,30951,30951,0
Tiaret,55-59 ans,11763,11361,23124,23124,0
Tiaret,60-64 ans,7449,7446,14895,14895,0
Tiaret,65-69 ans,8145,7171,15316,15316,0
Tiaret,70-74 ans,6431,5796,12226,12227,1
Tiaret,75-79 ans,4933,4139,9073,9072,-1
Tiaret,80-84 ans,2300,2045,4344,4345,1
Tiaret,85 ans &  +,1608,1639,3248,3247,-1
Alger,0-4 Ans,146656,138304,284960,284960,0
Alger,5-9 ans,114818,110294,225112,225112,0
Alger,10-14 ans,122211,116655,238866,238866,0
Alger,15-19 ans,130532,127020,257552,257552,0
Alger,20-24 ans,137304,138372,275676,275676,0
Alger,25-29 ans,140152,142229,282381,282381,0
Alger,30-34 ans,130469,129815,260284,260284,0
Alger,35-39 ans,124341,126600,250941,250941,0
Alger,40-44 ans,112399,111490,223889,223889,0
Alger,45-49 ans,83929,81948,165877,165877,0
Alger,50-54ans,68536,66759,135295,135295,0
Alger,55-59 ans,55823,54422,110245,110245,0
Alger,60-64 ans,36751,40546,77297,77297,0
Alger,65-69 ans,32067,34400,66467,66467,0
Alger,70-74 ans,26352,28499,54851,54851,0
Alger,75-79 ans,18885,19219,38104,38104,0
Alger,80-84 ans,9069,9868,18937,18937,0
Alger,85 ans &  +,5905,7514,13419,13419,0
Jijel,0-4 Ans,28384,26927,55311,55311,0
Jijel,5-9 ans,26651,25117,51768,51768,0
Jijel,10-14 ans,32329,31499,63828,63828,0
Jijel,15-19 ans,39727,38604,78331,78331,0
Jijel,20-24 ans,39037,38447,77484,77484,0
Jijel,25-29 ans,32909,31771,64680,64680,0
Jijel,30-34 ans,24785,24833,49618,49618,0
Jijel,35-39 ans,19882,20612,40494,40494,0
Jijel,40-44 ans,17785,17864,35649,35649,0
Jijel,45-49 ans,13052,13017,26069,26069,0
Jijel,50-54ans,11183,11293,22476,22476,0
Jijel,55-59 ans,10622,10307,20929,20929,0
Jijel,60-64 ans,7196,7184,14380,14380,0
Jijel,65-69 ans,5692,5987,11679,11679,0
Jijel,70-74 ans,4523,5211,9734,9734,0
Jijel,75-79 ans,3805,3961,7766,7766,0
Jijel,80-84 ans,1954,1990,3945,3944,-1
Jijel,85 ans &  +,1224,1366,2590,2590,0
Setif,0-4 Ans,77222,73297,150519,150519,0
Setif,5-9 ans,62700,61217,123917,123917,0
Setif,10-14 ans,75101,72249,147349,147350,1
Setif,15-19 ans,87369,84269,171638,171638,0
Setif,20-24 ans,90392,86466,176858,176858,0
Setif,25-29 ans,78193,73823,152017,152016,-1
Setif,30-34 ans,60731,58867,119597,119598,1
Setif,35-39 ans,46734,46805,93538,93539,1
Setif,40-44 ans,40396,40728,81124,81124,0
Setif,45-49 ans,36017,36252,72269,72269,0
Setif,50-54ans,28990,27951,56941,56941,0
Setif,55-59 ans,22833,21353,44185,44186,1
Setif,60-64 ans,13393,13577,26969,26970,1
Setif,65-69 ans,11912,12304,24215,24216,1
Setif,70-74 ans,10281,10475,20756,20756,0
Setif,75-79 ans,7611,7193,14804,14804,0
Setif,80-84 ans,3840,3617,7457,7457,0
Setif,85 ans &  +,2479,2610,5090,5089,-1
Skikda,0-4 Ans,40957,39308,80264,80265,1
Skikda,5-9 ans,36691,35292,71983,71983,0
Skikda,10-14 ans,43092,41505,84597,84597,0
Skikda,15-19 ans,49635,48385,98021,98020,-1
Skikda,20-24 ans,49364,50170,99534,99534,0
Skikda,25-29 ans,46024,45518,91542,91542,0
Skikda,30-34 ans,37049,37700,74750,74749,-1
Skikda,35-39 ans,31698,32608,64306,64306,0
Skikda,40-44 ans,27189,26975,54164,54164,0
Skikda,45-49 ans,19582,19519,39101,39101,0
Skikda,50-54ans,18574,17774,36348,36348,0
Skikda,55-59 ans,15576,14380,29956,29956,0
Skikda,60-64 ans,11319,10740,22060,22059,-1
Skikda,65-69 ans,8849,9130,17979,17979,0
Skikda,70-74 ans,6837,7122,13959,13959,0
Skikda,75-79 ans,5306,5381,10688,10687,-1
Skikda,80-84 ans,2773,2694,5467,5467,0
Skikda,85 ans &  +,1687,1817,3504,3504,0
Annaba,0-4 Ans,26500,24835,51335,51335,0
Annaba,5-9 ans,22100,20826,42926,42926,0
Annaba,10-14 ans,25255,24380,49635,49635,0
Annaba,15-19 ans,28703,27917,56621,56620,-1
Annaba,20-24 ans,29916,30115,60031,60031,0
Annaba,25-29 ans,30367,30955,61323,61322,-1
Annaba,30-34 ans,27187,27273,54459,54460,1
Annaba,35-39 ans,23084,24066,47150,47150,0
Annaba,40-44 ans,20637,21526,42163,42163,0
Annaba,45-49 ans,17323,17843,35166,35166,0
Annaba,50-54ans,14860,15154,30014,30014,0
Annaba,55-59 ans,12835,12068,24903,24903,0
Annaba,60-64 ans,8167,8309,16476,16476,0
Annaba,65-69 ans,6366,6851,13216,13217,1
Annaba,70-74 ans,5126,5256,10383,10382,-1
Annaba,75-79 ans,3579,3670,7250,7249,-1
Annaba,80-84 ans,1876,1933,3809,3809,0
Annaba,85 ans &  +,1008,1315,2323,2323,0
Saida,0-4 Ans,16838,16358,33196,33196,0
Saida,5-9 ans,13761,13414,27175,27175,0
Saida,10-14 ans,15268,14877,30145,30145,0
Saida,15-19 ans,16811,16164,32974,32975,1
Saida,20-24 ans,18348,18424,36772,36772,0
Saida,25-29 ans,17679,17452,35131,35131,0
Saida,30-34 ans,14957,14661,29618,29618,0
Saida,35-39 ans,11980,11794,23774,23774,0
Saida,40-44 ans,9678,9855,19532,19533,1
Saida,45-49 ans,7275,7569,14845,14844,-1
Saida,50-54ans,6291,6391,12682,12682,0
Saida,55-59 ans,5159,4957,10116,10116,0
Saida,60-64 ans,3419,3331,6750,6750,0
Saida,65-69 ans,3470,3089,6559,6559,0
Saida,70-74 ans,2431,2220,4651,4651,0
Saida,75-79 ans,1676,1640,3317,3316,-1
Saida,80-84 ans,875,935,1810,1810,0
Saida,85 ans &  +,779,781,1560,1560,0
Sidi Bel Abbes,0-4 Ans,29541,28218,57759,57759,0
Sidi Bel Abbes,5-9 ans,23723,22960,46682,46683,1
Sidi Bel Abbes,10-14 ans,26410,25495,51904,51905,1
Sidi Bel Abbes,15-19 ans,27918,26956,54874,54874,0
Sidi Bel Abbes,20-24 ans,31312,30839,62151,62151,0
Sidi Bel Abbes,25-29 ans,31408,30705,62113,62113,0
Sidi Bel Abbes,30-34 ans,26909,26176,53085,53085,0
Sidi Bel Abbes,35-39 ans,22806,22811,45617,45617,0
Sidi Bel Abbes,40-44 ans,19944,20142,40086,40086,0
Sidi Bel Abbes,45-49 ans,15347,15533,30880,30880,0
Sidi Bel Abbes,50-54ans,13697,13078,26775,26775,0
Sidi Bel Abbes,55-59 ans,10529,10122,20651,20651,0
Sidi Bel Abbes,60-64 ans,7198,7289,14486,14487,1
Sidi Bel Abbes,65-69 ans,6636,6823,13459,13459,0
Sidi Bel Abbes,70-74 ans,5143,5299,10441,10442,1
Sidi Bel Abbes,75-79 ans,3464,3569,7033,7033,0
Sidi Bel Abbes,80-84 ans,1769,1936,3705,3705,0
Sidi Bel Abbes,85 ans &  +,1307,1544,2852,2851,-1
Guelma,0-4 Ans,21593,20730,42323,42323,0
Guelma,5-9 ans,18678,17786,36465,36464,-1
Guelma,10-14 ans,21384,20991,42376,42375,-1
Guelma,15-19 ans,24878,23909,48787,48787,0
Guelma,20-24 ans,26019,25954,51973,51973,0
Guelma,25-29 ans,24822,24545,49367,49367,0
Guelma,30-34 ans,19635,20155,39791,39790,-1
Guelma,35-39 ans,16550,17208,33758,33758,0
Guelma,40-44 ans,15092,15269,30361,30361,0
Guelma,45-49 ans,13300,13821,27121,27121,0
Guelma,50-54ans,11254,10964,22218,22218,0
Guelma,55-59 ans,9109,8285,17395,17394,-1
Guelma,60-64 ans,5887,5409,11296,11296,0
Guelma,65-69 ans,4959,5115,10074,10074,0
Guelma,70-74 ans,3794,4073,7866,7867,1
Guelma,75-79 ans,2894,2906,5800,5800,0
Guelma,80-84 ans,1617,1710,3327,3327,0
Guelma,85 ans &  +,909,1117,2026,2026,0
Constantine,0-4 Ans,43862,41930,85791,85792,1
Constantine,5-9 ans,36055,34848,70903,70903,0
Constantine,10-14 ans,42780,41143,83923,83923,0
Constantine,15-19 ans,49507,48115,97622,97622,0
Constantine,20-24 ans,50811,49706,100517,100517,0
Constantine,25-29 ans,44551,43905,88455,88456,1
Constantine,30-34 ans,37003,37162,74165,74165,0
Constantine,35-39 ans,32518,34339,66858,66857,-1
Constantine,40-44 ans,30502,31358,61860,61860,0
Constantine,45-49 ans,26015,25578,51593,51593,0
Constantine,50-54ans,22130,21395,43525,43525,0
Constantine,55-59 ans,16714,16013,32727,32727,0
Constantine,60-64 ans,10891,11950,22841,22841,0
Constantine,65-69 ans,9217,10411,19629,19628,-1
Constantine,70-74 ans,7524,8611,16135,16135,0
Constantine,75-79 ans,5542,6086,11628,11628,0
Constantine,80-84 ans,2833,3289,6122,6122,0
Constantine,85 ans &  +,1667,2135,3802,3802,0
Mostaganem,0-4 Ans,37060,35711,72771,72771,0
Mostaganem,5-9 ans,31537,30859,62396,62396,0
Mostaganem,10-14 ans,35559,34561,70121,70120,-1
Mostaganem,15-19 ans,39847,39317,79163,79164,1
Mostaganem,20-24 ans,43027,42960,85987,85987,0
Mostaganem,25-29 ans,38679,38429,77108,77108,0
Mostaganem,30-34 ans,29626,29870,59496,59496,0
Mostaganem,35-39 ans,24341,24769,49110,49110,0
Mostaganem,40-44 ans,20935,21023,41958,41958,0
Mostaganem,45-49 ans,18481,17942,36423,36423,0
Mostaganem,50-54ans,14903,14404,29307,29307,0
Mostaganem,55-59 ans,11603,10663,22266,22266,0
Mostaganem,60-64 ans,7622,7625,15246,15247,1
Mostaganem,65-69 ans,6467,6809,13276,13276,0
Mostaganem,70-74 ans,4863,5523,10386,10386,0
Mostaganem,75-79 ans,3190,3661,6852,6851,-1
Mostaganem,80-84 ans,1339,1600,2939,2939,0
Mostaganem,85 ans &  +,833,1214,2048,2047,-1
Mascara,0-4 Ans,41611,39725,81336,81336,0
Mascara,5-9 ans,33857,32615,66472,66472,0
Mascara,10-14 ans,36990,36123,73113,73113,0
Mascara,15-19 ans,38560,37688,76248,76248,0
Mascara,20-24 ans,42474,41633,84107,84107,0
Mascara,25-29 ans,41043,38414,79457,79457,0
Mascara,30-34 ans,34319,31958,66277,66277,0
Mascara,35-39 ans,28300,27197,55497,55497,0
Mascara,40-44 ans,23530,22898,46427,46428,1
Mascara,45-49 ans,18853,18411,37264,37264,0
Mascara,50-54ans,16312,15577,31889,31889,0
Mascara,55-59 ans,12968,12301,25269,25269,0
Mascara,60-64 ans,8728,8726,17453,17454,1
Mascara,65-69 ans,8073,7749,15822,15822,0
Mascara,70-74 ans,6056,6104,12160,12160,0
Mascara,75-79 ans,3815,4117,7931,7932,1
Mascara,80-84 ans,1746,1926,3672,3672,0
Mascara,85 ans &  +,1161,1631,2792,2792,0
Medea,0-4 Ans,41401,38815,80216,80216,0
Medea,5-9 ans,33539,32054,65593,65593,0
Medea,10-14 ans,40638,39044,79682,79682,0
Medea,15-19 ans,46915,45579,92494,92494,0
Medea,20-24 ans,48156,46734,94890,94890,0
Medea,25-29 ans,44599,42859,87458,87458,0
Medea,30-34 ans,34700,33493,68192,68193,1
Medea,35-39 ans,28322,28692,57015,57014,-1
Medea,40-44 ans,22487,22280,44767,44767,0
Medea,45-49 ans,18643,18530,37173,37173,0
Medea,50-54ans,15278,14858,30136,30136,0
Medea,55-59 ans,11912,10979,22891,22891,0
Medea,60-64 ans,8360,7881,16241,16241,0
Medea,65-69 ans,7689,7017,14706,14706,0
Medea,70-74 ans,5949,5854,11803,11803,0
Medea,75-79 ans,4455,3790,8245,8245,0
Medea,80-84 ans,2349,1832,4181,4181,0
Medea,85 ans &  +,1679,1394,3073,3073,0
M'Sila,0-4 Ans,58420,54954,113374,113374,0
M'Sila,5-9 ans,49175,46926,96101,96101,0
M'Sila,10-14 ans,55151,53279,108430,108430,0
M'Sila,15-19 ans,61004,58547,119551,119551,0
M'Sila,20-24 ans,58986,58195,117180,117181,1
M'Sila,25-29 ans,49919,48674,98593,98593,0
M'Sila,30-34 ans,37614,36628,74242,74242,0
M'Sila,35-39 ans,29463,28798,58261,58261,0
M'Sila,40-44 ans,23504,23358,46862,46862,0
M'Sila,45-49 ans,21352,21045,42397,42397,0
M'Sila,50-54ans,16774,16463,33237,33237,0
M'Sila,55-59 ans,12716,11958,24674,24674,0
M'Sila,60-64 ans,7779,7358,15137,15137,0
M'Sila,65-69 ans,7301,6866,14167,14167,0
M'Sila,70-74 ans,6279,5451,11730,11730,0
M'Sila,75-79 ans,4687,3881,8568,8568,0
M'Sila,80-84 ans,2648,1966,4614,4614,0
M'Sila,85 ans &  +,1852,1462,3313,3314,1
Ouargla,0-4 Ans,35089,33400,68490,68489,-1
Ouargla,5-9 ans,30540,29392,59932,59932,0
Ouargla,10-14 ans,32739,31603,64342,64342,0
Ouargla,15-19 ans,33786,32526,66311,66312,1
Ouargla,20-24 ans,31961,31389,63350,63350,0
Ouargla,25-29 ans,27085,27196,54282,54281,-1
Ouargla,30-34 ans,19490,19690,39181,39180,-1
Ouargla,35-39 ans,16357,16814,33171,33171,0
Ouargla,40-44 ans,13452,13727,27179,27179,0
Ouargla,45-49 ans,11945,11877,23821,23822,1
Ouargla,50-54ans,9234,8238,17472,17472,0
Ouargla,55-59 ans,6287,5317,11604,11604,0
Ouargla,60-64 ans,4387,4111,8498,8498,0
Ouargla,65-69 ans,3716,3331,7047,7047,0
Ouargla,70-74 ans,2906,2411,5316,5317,1
Ouargla,75-79 ans,2110,1756,3866,3866,0
Ouargla,80-84 ans,1063,966,2030,2029,-1
Ouargla,85 ans &  +,812,902,1714,1714,0
Oran,0-4 Ans,72455,69512,141966,141967,1
Oran,5-9 ans,59498,57547,117045,117045,0
Oran,10-14 ans,64211,62081,126292,126292,0
Oran,15-19 ans,66506,65372,131878,131878,0
Oran,20-24 ans,72160,73163,145323,145323,0
Oran,25-29 ans,70391,70800,141190,141191,1
Oran,30-34 ans,62042,62203,124245,124245,0
Oran,35-39 ans,55000,55137,110137,110137,0
Oran,40-44 ans,49667,50082,99749,99749,0
Oran,45-49 ans,39798,40200,79998,79998,0
Oran,50-54ans,33154,33092,66246,66246,0
Oran,55-59 ans,26840,25573,52413,52413,0
Oran,60-64 ans,17251,17832,35082,35083,1
Oran,65-69 ans,14806,14745,29552,29551,-1
Oran,70-74 ans,11187,12288,23475,23475,0
Oran,75-79 ans,7035,8269,15304,15304,0
Oran,80-84 ans,3230,3974,7203,7204,1
Oran,85 ans &  +,1987,3232,5219,5219,0
Illizi,0-4 Ans,3929,3634,7563,7563,0
Illizi,5-9 ans,3179,2997,6176,6176,0
Illizi,10-14 ans,2786,2670,5456,5456,0
Illizi,15-19 ans,2885,2455,5340,5340,0
Illizi,20-24 ans,2878,2556,5434,5434,0
Illizi,25-29 ans,2860,2490,5350,5350,0
Illizi,30-34 ans,2261,2030,4290,4291,1
Illizi,35-39 ans,2021,1456,3478,3477,-1
Illizi,40-44 ans,1609,1114,2722,2723,1
Illizi,45-49 ans,1223,860,2083,2083,0
Illizi,50-54ans,761,555,1316,1316,0
Illizi,55-59 ans,507,385,893,892,-1
Illizi,60-64 ans,395,282,677,677,0
Illizi,65-69 ans,336,212,548,548,0
Illizi,70-74 ans,227,132,358,359,1
Illizi,75-79 ans,160,93,253,253,0
Illizi,80-84 ans,80,55,135,135,0
Illizi,85 ans &  +,60,55,115,115,0
Boumerdes,0-4 Ans,41044,38798,79843,79842,-1
Boumerdes,5-9 ans,31081,29771,60852,60852,0
Boumerdes,10-14 ans,35308,32875,68183,68183,0
Boumerdes,15-19 ans,41870,39564,81434,81434,0
Boumerdes,20-24 ans,45756,44157,89913,89913,0
Boumerdes,25-29 ans,44117,41437,85555,85554,-1
Boumerdes,30-34 ans,35806,33284,69090,69090,0
Boumerdes,35-39 ans,30571,29186,59757,59757,0
Boumerdes,40-44 ans,24849,23726,48575,48575,0
Boumerdes,45-49 ans,19561,18069,37630,37630,0
Boumerdes,50-54ans,17036,15756,32792,32792,0
Boumerdes,55-59 ans,13811,12308,26120,26119,-1
Boumerdes,60-64 ans,9604,9156,18759,18760,1
Boumerdes,65-69 ans,7942,7548,15490,15490,0
Boumerdes,70-74 ans,5482,5881,11364,11363,-1
Boumerdes,75-79 ans,3845,4342,8187,8187,0
Boumerdes,80-84 ans,2137,2265,4403,4402,-1
Boumerdes,85 ans &  +,1344,1677,3021,3021,0
El Bayadh,0-4 Ans,13505,12852,26358,26357,-1
El Bayadh,5-9 ans,12108,11390,23498,23498,0
El Bayadh,10-14 ans,12291,12060,24352,24351,-1
El Bayadh,15-19 ans,12134,11659,23793,23793,0
El Bayadh,20-24 ans,11739,11907,23646,23646,0
El Bayadh,25-29 ans,10800,11087,21887,21887,0
El Bayadh,30-34 ans,8947,9376,18323,18323,0
El Bayadh,35-39 ans,7706,7778,15485,15484,-1
El Bayadh,40-44 ans,6350,6257,12607,12607,0
El Bayadh,45-49 ans,4637,4388,9024,9025,1
El Bayadh,50-54ans,3966,3796,7762,7762,0
El Bayadh,55-59 ans,3013,2902,5915,5915,0
El Bayadh,60-64 ans,1937,1867,3804,3804,0
El Bayadh,65-69 ans,2012,1868,3881,3880,-1
El Bayadh,70-74 ans,1564,1408,2973,2972,-1
El Bayadh,75-79 ans,1216,1087,2304,2303,-1
El Bayadh,80-84 ans,718,635,1353,1353,0
El Bayadh,85 ans &  +,665,713,1378,1378,0
Bordj Bou Arreridj,0-4 Ans,33075,31376,64451,64451,0
Bordj Bou Arreridj,5-9 ans,27432,26026,53458,53458,0
Bordj Bou Arreridj,10-14 ans,32298,31221,63519,63519,0
Bordj Bou Arreridj,15-19 ans,37830,36502,74332,74332,0
Bordj Bou Arreridj,20-24 ans,38242,36583,74825,74825,0
Bordj Bou Arreridj,25-29 ans,33554,31411,64965,64965,0
Bordj Bou Arreridj,30-34 ans,24978,23988,48966,48966,0
Bordj Bou Arreridj,35-39 ans,19587,19568,39155,39155,0
Bordj Bou Arreridj,40-44 ans,16386,15974,32360,32360,0
Bordj Bou Arreridj,45-49 ans,14855,13910,28765,28765,0
Bordj Bou Arreridj,50-54ans,11517,11043,22560,22560,0
Bordj Bou Arreridj,55-59 ans,9441,8756,18197,18197,0
Bordj Bou Arreridj,60-64 ans,5484,5515,10999,10999,0
Bordj Bou Arreridj,65-69 ans,5115,5117,10232,10232,0
Bordj Bou Arreridj,70-74 ans,4516,4545,9061,9061,0
Bordj Bou Arreridj,75-79 ans,3375,3275,6650,6650,0
Bordj Bou Arreridj,80-84 ans,1833,1615,3448,3448,0
Bordj Bou Arreridj,85 ans &  +,1140,1046,2186,2186,0
El Tarf,0-4 Ans,18486,17353,35838,35839,1
El Tarf,5-9 ans,15752,15059,30811,30811,0
El Tarf,10-14 ans,18182,17617,35798,35799,1
El Tarf,15-19 ans,20252,19785,40037,40037,0
El Tarf,20-24 ans,21056,21539,42595,42595,0
El Tarf,25-29 ans,21450,22224,43674,43674,0
El Tarf,30-34 ans,17615,18980,36595,36595,0
El Tarf,35-39 ans,15068,15596,30664,30664,0
El Tarf,40-44 ans,13153,13696,26849,26849,0
El Tarf,45-49 ans,10745,11128,21873,21873,0
El Tarf,50-54ans,8966,8908,17873,17874,1
El Tarf,55-59 ans,6871,6563,13434,13434,0
El Tarf,60-64 ans,4884,4927,9811,9811,0
El Tarf,65-69 ans,3883,3828,7712,7711,-1
El Tarf,70-74 ans,3207,3128,6335,6335,0
El Tarf,75-79 ans,2288,2153,4440,4441,1
El Tarf,80-84 ans,1313,1179,2493,2492,-1
El Tarf,85 ans &  +,725,762,1487,1487,0
Tindouf,0-4 Ans,3116,3049,6166,6165,-1
Tindouf,5-9 ans,2484,2611,5094,5095,1
Tindouf,10-14 ans,2561,2524,5086,5085,-1
Tindouf,15-19 ans,2618,2489,5108,5107,-1
Tindouf,20-24 ans,2453,2608,5061,5061,0
Tindouf,25-29 ans,2413,2547,4960,4960,0
Tindouf,30-34 ans,1964,1960,3923,3924,1
Tindouf,35-39 ans,1737,1575,3312,3312,0
Tindouf,40-44 ans,1584,1321,2905,2905,0
Tindouf,45-49 ans,1150,1069,2219,2219,0
Tindouf,50-54ans,792,740,1533,1532,-1
Tindouf,55-59 ans,672,638,1310,1310,0
Tindouf,60-64 ans,461,346,807,807,0
Tindouf,65-69 ans,364,304,668,668,0
Tindouf,70-74 ans,233,144,377,377,0
Tindouf,75-79 ans,174,121,295,295,0
Tindouf,80-84 ans,102,57,159,159,0
Tindouf,85 ans &  +,75,49,124,124,0
El Oued,0-4 Ans,44197,41677,85873,85874,1
El Oued,5-9 ans,37321,35653,72974,72974,0
El Oued,10-14 ans,39479,37748,77227,77227,0
El Oued,15-19 ans,40831,39694,80524,80525,1
El Oued,20-24 ans,37154,35948,73102,73102,0
El Oued,25-29 ans,30265,29436,59701,59701,0
El Oued,30-34 ans,20564,20224,40789,40788,-1
El Oued,35-39 ans,17478,17595,35073,35073,0
El Oued,40-44 ans,14501,14420,28921,28921,0
El Oued,45-49 ans,12171,12116,24287,24287,0
El Oued,50-54ans,9325,9136,18460,18461,1
El Oued,55-59 ans,6546,6348,12894,12894,0
El Oued,60-64 ans,4946,4888,9834,9834,0
El Oued,65-69 ans,4605,4437,9041,9042,1
El Oued,70-74 ans,3727,3191,6918,6918,0
El Oued,75-79 ans,3201,2443,5644,5644,0
El Oued,80-84 ans,1539,1175,2713,2714,1
El Oued,85 ans &  +,1198,1132,2330,2330,0
Souk Ahras,0-4 Ans,20746,20008,40755,40754,-1
Souk Ahras,5-9 ans,18044,17236,35280,35280,0
Souk Ahras,10-14 ans,20788,19745,40533,40533,0
Souk Ahras,15-19 ans,22427,21867,44294,44294,0
Souk Ahras,20-24 ans,23909,24732,48641,48641,0
Souk Ahras,25-29 ans,22630,23488,46118,46118,0
Souk Ahras,30-34 ans,17022,18064,35086,35086,0
Souk Ahras,35-39 ans,14854,15511,30365,30365,0
Souk Ahras,40-44 ans,13061,13292,26354,26353,-1
Souk Ahras,45-49 ans,11473,11414,22887,22887,0
Souk Ahras,50-54ans,9027,9048,18075,18075,0
Souk Ahras,55-59 ans,7601,7160,14761,14761,0
Souk Ahras,60-64 ans,4700,4904,9604,9604,0
Souk Ahras,65-69 ans,4256,4240,8497,8496,-1
Souk Ahras,70-74 ans,3237,3450,6687,6687,0
Souk Ahras,75-79 ans,2676,2649,5325,5325,0
Souk Ahras,80-84 ans,1534,1422,2956,2956,0
Souk Ahras,85 ans &  +,891,922,1812,1813,1
Tissemsilt,0-4 Ans,14481,13409,27889,27890,1
Tissemsilt,5-9 ans,13087,12063,25150,25150,0
Tissemsilt,10-14 ans,15387,14728,30115,30115,0
Tissemsilt,15-19 ans,18282,17658,35940,35940,0
Tissemsilt,20-24 ans,18009,17686,35695,35695,0
Tissemsilt,25-29 ans,15376,14988,30364,30364,0
Tissemsilt,30-34 ans,11110,11763,22872,22873,1
Tissemsilt,35-39 ans,9362,9760,19122,19122,0
Tissemsilt,40-44 ans,8011,8287,16298,16298,0
Tissemsilt,45-49 ans,5728,5744,11471,11472,1
Tissemsilt,50-54ans,5294,5104,10398,10398,0
Tissemsilt,55-59 ans,4295,3964,8259,8259,0
Tissemsilt,60-64 ans,2863,2639,5502,5502,0
Tissemsilt,65-69 ans,2731,2471,5202,5202,0
Tissemsilt,70-74 ans,2278,2012,4291,4290,-1
Tissemsilt,75-79 ans,1701,1502,3203,3203,0
Tissemsilt,80-84 ans,882,688,1571,1570,-1
Tissemsilt,85 ans &  +,530,529,1060,1059,-1
Khenchela,0-4 Ans,20143,18757,38900,38900,0
Khenchela,5-9 ans,18261,17350,35612,35611,-1
Khenchela,10-14 ans,20531,19801,40332,40332,0
Khenchela,15-19 ans,22193,21238,43430,43431,1
Khenchela,20-24 ans,22221,21599,43820,43820,0
Khenchela,25-29 ans,19271,19213,38483,38484,1
Khenchela,30-34 ans,14489,14857,29346,29346,0
Khenchela,35-39 ans,11759,12314,24073,24073,0
Khenchela,40-44 ans,11073,11092,22164,22165,1
Khenchela,45-49 ans,8503,9020,17523,17523,0
Khenchela,50-54ans,7465,7487,14952,14952,0
Khenchela,55-59 ans,6300,5766,12066,12066,0
Khenchela,60-64 ans,3370,3394,6764,6764,0
Khenchela,65-69 ans,3336,3229,6565,6565,0
Khenchela,70-74 ans,2577,2531,5108,5108,0
Khenchela,75-79 ans,2148,1881,4030,4029,-1
Khenchela,80-84 ans,1046,918,1964,1964,0
Khenchela,85 ans &  +,754,652,1406,1406,0
Tipaza,0-4 Ans,30051,28453,58504,58504,0
Tipaza,5-9 ans,24237,22980,47217,47217,0
Tipaza,10-14 ans,26917,26032,52949,52949,0
Tipaza,15-19 ans,30649,29831,60480,60480,0
Tipaza,20-24 ans,31552,31366,62918,62918,0
Tipaza,25-29 ans,29398,28922,58320,58320,0
Tipaza,30-34 ans,24492,24623,49114,49115,1
Tipaza,35-39 ans,22328,22227,44555,44555,0
Tipaza,40-44 ans,19686,19692,39377,39378,1
Tipaza,45-49 ans,14420,14061,28481,28481,0
Tipaza,50-54ans,12281,11799,24080,24080,0
Tipaza,55-59 ans,9690,8760,18450,18450,0
Tipaza,60-64 ans,6769,6669,13438,13438,0
Tipaza,65-69 ans,5856,5668,11524,11524,0
Tipaza,70-74 ans,4630,4631,9261,9261,0
Tipaza,75-79 ans,3094,3124,6218,6218,0
Tipaza,80-84 ans,1494,1529,3023,3023,0
Tipaza,85 ans &  +,909,1096,2005,2005,0
Mila,0-4 Ans,37192,35509,72701,72701,0
Mila,5-9 ans,32225,31184,63409,63409,0
Mila,10-14 ans,40473,38886,79360,79359,-1
Mila,15-19 ans,46635,45842,92477,92477,0
Mila,20-24 ans,45801,44555,90357,90356,-1
Mila,25-29 ans,37709,36601,74309,74310,1
Mila,30-34 ans,28670,28796,57466,57466,0
Mila,35-39 ans,22947,23635,46582,46582,0
Mila,40-44 ans,21232,21716,42948,42948,0
Mila,45-49 ans,18908,19307,38215,38215,0
Mila,50-54ans,14836,14891,29726,29727,1
Mila,55-59 ans,11829,11356,23185,23185,0
Mila,60-64 ans,8274,8284,16558,16558,0
Mila,65-69 ans,6768,7108,13876,13876,0
Mila,70-74 ans,5756,5432,11188,11188,0
Mila,75-79 ans,3847,3712,7559,7559,0
Mila,80-84 ans,2095,1955,4050,4050,0
Mila,85 ans &  +,1314,1377,2691,2691,0
Naama,0-4 Ans,11107,10645,21753,21752,-1
Naama,5-9 ans,9507,9157,18664,18664,0
Naama,10-14 ans,9560,9193,18752,18753,1
Naama,15-19 ans,9807,9500,19306,19307,1
Naama,20-24 ans,10079,10257,20336,20336,0
Naama,25-29 ans,9912,10036,19948,19948,0
Naama,30-34 ans,8530,8096,16626,16626,0
Naama,35-39 ans,7079,6685,13764,13764,0
Naama,40-44 ans,5472,5249,10721,10721,0
Naama,45-49 ans,4139,3818,7957,7957,0
Naama,50-54ans,3541,3484,7025,7025,0
Naama,55-59 ans,2449,2225,4675,4674,-1
Naama,60-64 ans,1745,1656,3401,3401,0
Naama,65-69 ans,2013,1683,3696,3696,0
Naama,70-74 ans,1177,1144,2321,2321,0
Naama,75-79 ans,996,820,1816,1816,0
Naama,80-84 ans,647,511,1158,1158,0
Naama,85 ans &  +,469,371,840,840,0
Ghardaia,0-4 Ans,23781,22083,45864,45864,0
Ghardaia,5-9 ans,20110,19006,39116,39116,0
Ghardaia,10-14 ans,20190,19035,39226,39225,-1
Ghardaia,15-19 ans,19974,19388,39362,39362,0
Ghardaia,20-24 ans,18994,18643,37637,37637,0
Ghardaia,25-29 ans,16424,16132,32556,32556,0
Ghardaia,30-34 ans,13068,13019,26087,26087,0
Ghardaia,35-39 ans,11683,11771,23454,23454,0
Ghardaia,40-44 ans,10387,10220,20607,20607,0
Ghardaia,45-49 ans,8537,8288,16824,16825,1
Ghardaia,50-54ans,5908,5747,11655,11655,0
Ghardaia,55-59 ans,3864,3802,7666,7666,0
Ghardaia,60-64 ans,3151,2970,6121,6121,0
Ghardaia,65-69 ans,3001,2859,5860,5860,0
Ghardaia,70-74 ans,2575,2267,4842,4842,0
Ghardaia,75-79 ans,1746,1376,3122,3122,0
Ghardaia,80-84 ans,890,683,1573,1573,0
Ghardaia,85 ans &  +,634,686,1320,1320,0
Ain Defla,0-4 Ans,39759,37861,77620,77620,0
Ain Defla,5-9 ans,33635,32113,65748,65748,0
Ain Defla,10-14 ans,38932,37133,76065,76065,0
Ain Defla,15-19 ans,45513,44241,89754,89754,0
Ain Defla,20-24 ans,46201,44819,91020,91020,0
Ain Defla,25-29 ans,39608,38256,77864,77864,0
Ain Defla,30-34 ans,30155,29544,59698,59699,1
Ain Defla,35-39 ans,24744,25320,50064,50064,0
Ain Defla,40-44 ans,21147,21353,42500,42500,0
Ain Defla,45-49 ans,15661,16253,31914,31914,0
Ain Defla,50-54ans,14319,13901,28220,28220,0
Ain Defla,55-59 ans,11430,10496,21925,21926,1
Ain Defla,60-64 ans,7837,7267,15104,15104,0
Ain Defla,65-69 ans,7033,6423,13456,13456,0
Ain Defla,70-74 ans,5483,5310,10793,10793,0
Ain Defla,75-79 ans,3784,3562,7346,7346,0
Ain Defla,80-84 ans,1995,1761,3755,3756,1
Ain Defla,85 ans &  +,1197,1216,2413,2413,0
Ain Temouchent,0-4 Ans,17996,17181,35177,35177,0
Ain Temouchent,5-9 ans,14738,14072,28810,28810,0
Ain Temouchent,10-14 ans,15716,15252,30969,30968,-1
Ain Temouchent,15-19 ans,16284,16018,32303,32302,-1
Ain Temouchent,20-24 ans,17830,17205,35035,35035,0
Ain Temouchent,25-29 ans,18482,18083,36565,36565,0
Ain Temouchent,30-34 ans,16542,16226,32768,32768,0
Ain Temouchent,35-39 ans,14625,14407,29031,29032,1
Ain Temouchent,40-44 ans,13035,13035,26070,26070,0
Ain Temouchent,45-49 ans,10377,9985,20362,20362,0
Ain Temouchent,50-54ans,8862,8444,17305,17306,1
Ain Temouchent,55-59 ans,7154,6641,13795,13795,0
Ain Temouchent,60-64 ans,4788,4861,9649,9649,0
Ain Temouchent,65-69 ans,4112,4158,8270,8270,0
Ain Temouchent,70-74 ans,3286,3407,6694,6693,-1
Ain Temouchent,75-79 ans,1921,2300,4221,4221,0
Ain Temouchent,80-84 ans,1059,1245,2304,2304,0
Ain Temouchent,85 ans &  +,618,957,1575,1575,0
Relizane,0-4 Ans,36021,34763,70784,70784,0
Relizane,5-9 ans,30832,29568,60400,60400,0
Relizane,10-14 ans,35931,34714,70645,70645,0
Relizane,15-19 ans,41319,40375,81694,81694,0
Relizane,20-24 ans,44701,43855,88556,88556,0
Relizane,25-29 ans,38773,37954,76727,76727,0
Relizane,30-34 ans,28901,29108,58009,58009,0
Relizane,35-39 ans,22757,23052,45809,45809,0
Relizane,40-44 ans,19834,20238,40072,40072,0
Relizane,45-49 ans,16960,17385,34345,34345,0
Relizane,50-54ans,14233,13594,27827,27827,0
Relizane,55-59 ans,11124,10545,21669,21669,0
Relizane,60-64 ans,6389,6484,12873,12873,0
Relizane,65-69 ans,6239,6191,12431,12430,-1
Relizane,70-74 ans,5620,5426,11046,11046,0
Relizane,75-79 ans,3782,3548,7330,7330,0
Relizane,80-84 ans,1661,1614,3276,3275,-1
Relizane,85 ans &  +,1078,1243,2321,2321,0
